e00001000
010001010
010000010
011111010
010100010
000101000
111101000
01m101000
000001000